-1, 0, 0, 0, 0,
-1, 0, 0, 1, 0,
-1, 0, 0, 0, 0,
-1,-1,-1, 0, 0,
 8, 9, 2, 0, 0,
